Republican EVs,Democrat EVs,Outcome,Electoral Margin,Binned Margin,Sample
293,245,Trump Wins,48,50,1
295,243,Trump Wins,52,55,1
286,252,Trump Wins,34,35,1
300,238,Trump Wins,62,65,1
276,262,Trump Wins,14,15,1
282,256,Trump Wins,26,30,1
275,263,Trump Wins,12,15,2
293,245,Trump Wins,48,50,2
275,263,Trump Wins,12,15,3
306,232,Trump Wins,74,75,1
312,226,Trump Wins,86,90,1
279,259,Trump Wins,20,25,1
301,237,Trump Wins,64,65,2
271,267,Trump Wins,4,5,1
283,255,Trump Wins,28,30,2
270,268,Trump Wins,2,5,2
301,237,Trump Wins,64,65,3
331,207,Trump Wins,124,125,1
270,268,Trump Wins,2,5,3
272,266,Trump Wins,6,10,1
290,248,Trump Wins,42,45,1
291,247,Trump Wins,44,45,2
296,242,Trump Wins,54,55,2
271,267,Trump Wins,4,5,4
322,216,Trump Wins,106,110,1
286,252,Trump Wins,34,35,2
303,235,Trump Wins,68,70,1
287,251,Trump Wins,36,40,1
298,240,Trump Wins,58,60,1
286,252,Trump Wins,34,35,3
316,222,Trump Wins,94,95,1
304,234,Trump Wins,70,75,2
283,255,Trump Wins,28,30,3
297,241,Trump Wins,56,60,2
299,239,Trump Wins,60,65,4
301,237,Trump Wins,64,65,5
289,249,Trump Wins,40,45,3
297,241,Trump Wins,56,60,3
287,251,Trump Wins,36,40,2
271,267,Trump Wins,4,5,5
297,241,Trump Wins,56,60,4
302,236,Trump Wins,66,70,2
300,238,Trump Wins,62,65,6
280,258,Trump Wins,22,25,2
313,225,Trump Wins,88,90,2
279,259,Trump Wins,20,25,3
322,216,Trump Wins,106,110,2
280,258,Trump Wins,22,25,4
280,258,Trump Wins,22,25,5
278,260,Trump Wins,18,20,1
281,257,Trump Wins,24,25,6
323,215,Trump Wins,108,110,3
271,267,Trump Wins,4,5,6
291,247,Trump Wins,44,45,4
305,233,Trump Wins,72,75,3
280,258,Trump Wins,22,25,7
303,235,Trump Wins,68,70,3
275,263,Trump Wins,12,15,4
311,227,Trump Wins,84,85,1
310,228,Trump Wins,82,85,2
292,246,Trump Wins,46,50,3
286,252,Trump Wins,34,35,4
287,251,Trump Wins,36,40,3
322,216,Trump Wins,106,110,4
316,222,Trump Wins,94,95,2
275,263,Trump Wins,12,15,5
287,251,Trump Wins,36,40,4
306,232,Trump Wins,74,75,4
297,241,Trump Wins,56,60,5
281,257,Trump Wins,24,25,8
286,252,Trump Wins,34,35,5
277,261,Trump Wins,16,20,2
295,243,Trump Wins,52,55,3
311,227,Trump Wins,84,85,3
282,256,Trump Wins,26,30,4
312,226,Trump Wins,86,90,3
306,232,Trump Wins,74,75,5
292,246,Trump Wins,46,50,4
275,263,Trump Wins,12,15,6
270,268,Trump Wins,2,5,7
289,249,Trump Wins,40,45,5
286,252,Trump Wins,34,35,6
314,224,Trump Wins,90,95,3
291,247,Trump Wins,44,45,6
302,236,Trump Wins,66,70,4
274,264,Trump Wins,10,15,7
296,242,Trump Wins,54,55,4
277,261,Trump Wins,16,20,3
306,232,Trump Wins,74,75,6
275,263,Trump Wins,12,15,8
270,268,Trump Wins,2,5,8
276,262,Trump Wins,14,15,9
311,227,Trump Wins,84,85,4
290,248,Trump Wins,42,45,7
314,224,Trump Wins,90,95,4
296,242,Trump Wins,54,55,5
282,256,Trump Wins,26,30,5
293,245,Trump Wins,48,50,5
296,242,Trump Wins,54,55,6
286,252,Trump Wins,34,35,7
289,249,Trump Wins,40,45,8
283,255,Trump Wins,28,30,6
297,241,Trump Wins,56,60,6
287,251,Trump Wins,36,40,5
300,238,Trump Wins,62,65,7
312,226,Trump Wins,86,90,4
296,242,Trump Wins,54,55,7
302,236,Trump Wins,66,70,5
272,266,Trump Wins,6,10,2
271,267,Trump Wins,4,5,9
281,257,Trump Wins,24,25,9
328,210,Trump Wins,118,120,1
281,257,Trump Wins,24,25,10
278,260,Trump Wins,18,20,4
298,240,Trump Wins,58,60,7
280,258,Trump Wins,22,25,11
272,266,Trump Wins,6,10,3
307,231,Trump Wins,76,80,1
290,248,Trump Wins,42,45,9
281,257,Trump Wins,24,25,12
295,243,Trump Wins,52,55,8
287,251,Trump Wins,36,40,6
278,260,Trump Wins,18,20,5
281,257,Trump Wins,24,25,13
304,234,Trump Wins,70,75,7
278,260,Trump Wins,18,20,6
281,257,Trump Wins,24,25,14
287,251,Trump Wins,36,40,7
287,251,Trump Wins,36,40,8
283,255,Trump Wins,28,30,7
287,251,Trump Wins,36,40,9
306,232,Trump Wins,74,75,8
280,258,Trump Wins,22,25,15
291,247,Trump Wins,44,45,10
286,252,Trump Wins,34,35,8
275,263,Trump Wins,12,15,10
296,242,Trump Wins,54,55,9
291,247,Trump Wins,44,45,11
286,252,Trump Wins,34,35,9
326,212,Trump Wins,114,115,1
270,268,Trump Wins,2,5,10
327,211,Trump Wins,116,120,2
272,266,Trump Wins,6,10,4
287,251,Trump Wins,36,40,10
277,261,Trump Wins,16,20,7
278,260,Trump Wins,18,20,8
306,232,Trump Wins,74,75,9
271,267,Trump Wins,4,5,11
287,251,Trump Wins,36,40,11
290,248,Trump Wins,42,45,12
301,237,Trump Wins,64,65,8
281,257,Trump Wins,24,25,16
271,267,Trump Wins,4,5,12
291,247,Trump Wins,44,45,13
290,248,Trump Wins,42,45,14
283,255,Trump Wins,28,30,8
302,236,Trump Wins,66,70,6
281,257,Trump Wins,24,25,17
280,258,Trump Wins,22,25,18
295,243,Trump Wins,52,55,10
272,266,Trump Wins,6,10,5
289,249,Trump Wins,40,45,15
281,257,Trump Wins,24,25,19
271,267,Trump Wins,4,5,13
285,253,Trump Wins,32,35,10
293,245,Trump Wins,48,50,6
315,223,Trump Wins,92,95,5
282,256,Trump Wins,26,30,9
291,247,Trump Wins,44,45,16
292,246,Trump Wins,46,50,7
270,268,Trump Wins,2,5,14
272,266,Trump Wins,6,10,6
278,260,Trump Wins,18,20,9
283,255,Trump Wins,28,30,10
270,268,Trump Wins,2,5,15
285,253,Trump Wins,32,35,11
275,263,Trump Wins,12,15,11
294,244,Trump Wins,50,55,11
270,268,Trump Wins,2,5,16
288,250,Trump Wins,38,40,12
302,236,Trump Wins,66,70,7
271,267,Trump Wins,4,5,17
280,258,Trump Wins,22,25,20
297,241,Trump Wins,56,60,8
307,231,Trump Wins,76,80,2
280,258,Trump Wins,22,25,21
282,256,Trump Wins,26,30,11
326,212,Trump Wins,114,115,2
307,231,Trump Wins,76,80,3
272,266,Trump Wins,6,10,7
278,260,Trump Wins,18,20,10
281,257,Trump Wins,24,25,22
322,216,Trump Wins,106,110,5
296,242,Trump Wins,54,55,12
286,252,Trump Wins,34,35,12
293,245,Trump Wins,48,50,8
293,245,Trump Wins,48,50,9
289,249,Trump Wins,40,45,17
272,266,Trump Wins,6,10,8
272,266,Trump Wins,6,10,9
293,245,Trump Wins,48,50,10
280,258,Trump Wins,22,25,23
287,251,Trump Wins,36,40,13
271,267,Trump Wins,4,5,18
281,257,Trump Wins,24,25,24
270,268,Trump Wins,2,5,19
286,252,Trump Wins,34,35,13
281,257,Trump Wins,24,25,25
327,211,Trump Wins,116,120,3
280,258,Trump Wins,22,25,26
286,252,Trump Wins,34,35,14
280,258,Trump Wins,22,25,27
301,237,Trump Wins,64,65,9
286,252,Trump Wins,34,35,15
280,258,Trump Wins,22,25,28
289,249,Trump Wins,40,45,18
287,251,Trump Wins,36,40,14
296,242,Trump Wins,54,55,13
296,242,Trump Wins,54,55,14
293,245,Trump Wins,48,50,11
310,228,Trump Wins,82,85,5
276,262,Trump Wins,14,15,12
283,255,Trump Wins,28,30,12
281,257,Trump Wins,24,25,29
287,251,Trump Wins,36,40,15
281,257,Trump Wins,24,25,30
281,257,Trump Wins,24,25,31
275,263,Trump Wins,12,15,13
281,257,Trump Wins,24,25,32
294,244,Trump Wins,50,55,15
302,236,Trump Wins,66,70,8
302,236,Trump Wins,66,70,9
281,257,Trump Wins,24,25,33
299,239,Trump Wins,60,65,10
306,232,Trump Wins,74,75,10
327,211,Trump Wins,116,120,4
316,222,Trump Wins,94,95,6
288,250,Trump Wins,38,40,16
279,259,Trump Wins,20,25,34
296,242,Trump Wins,54,55,16
346,192,Trump Wins,154,155,1
270,268,Trump Wins,2,5,20
308,230,Trump Wins,78,80,4
281,257,Trump Wins,24,25,35
291,247,Trump Wins,44,45,19
290,248,Trump Wins,42,45,20
285,253,Trump Wins,32,35,16
309,229,Trump Wins,80,85,6
291,247,Trump Wins,44,45,21
312,226,Trump Wins,86,90,5
312,226,Trump Wins,86,90,6
286,252,Trump Wins,34,35,17
298,240,Trump Wins,58,60,9
281,257,Trump Wins,24,25,36
291,247,Trump Wins,44,45,22
285,253,Trump Wins,32,35,18
297,241,Trump Wins,56,60,10
291,247,Trump Wins,44,45,23
275,263,Trump Wins,12,15,14
312,226,Trump Wins,86,90,7
298,240,Trump Wins,58,60,11
314,224,Trump Wins,90,95,7
272,266,Trump Wins,6,10,10
308,230,Trump Wins,78,80,5
307,231,Trump Wins,76,80,6
289,249,Trump Wins,40,45,24
299,239,Trump Wins,60,65,11
270,268,Trump Wins,2,5,21
278,260,Trump Wins,18,20,11
312,226,Trump Wins,86,90,8
309,229,Trump Wins,80,85,7
274,264,Trump Wins,10,15,15
302,236,Trump Wins,66,70,10
271,267,Trump Wins,4,5,22
290,248,Trump Wins,42,45,25
293,245,Trump Wins,48,50,12
274,264,Trump Wins,10,15,16
299,239,Trump Wins,60,65,12
273,265,Trump Wins,8,10,11
292,246,Trump Wins,46,50,13
291,247,Trump Wins,44,45,26
306,232,Trump Wins,74,75,11
271,267,Trump Wins,4,5,23
280,258,Trump Wins,22,25,37
317,221,Trump Wins,96,100,1
296,242,Trump Wins,54,55,17
278,260,Trump Wins,18,20,12
297,241,Trump Wins,56,60,12
275,263,Trump Wins,12,15,17
290,248,Trump Wins,42,45,27
325,213,Trump Wins,112,115,3
296,242,Trump Wins,54,55,18
295,243,Trump Wins,52,55,19
294,244,Trump Wins,50,55,20
279,259,Trump Wins,20,25,38
302,236,Trump Wins,66,70,11
275,263,Trump Wins,12,15,18
297,241,Trump Wins,56,60,13
285,253,Trump Wins,32,35,19
270,268,Trump Wins,2,5,24
306,232,Trump Wins,74,75,12
286,252,Trump Wins,34,35,20
270,268,Trump Wins,2,5,25
281,257,Trump Wins,24,25,39
302,236,Trump Wins,66,70,12
280,258,Trump Wins,22,25,40
270,268,Trump Wins,2,5,26
278,260,Trump Wins,18,20,13
276,262,Trump Wins,14,15,19
273,265,Trump Wins,8,10,12
276,262,Trump Wins,14,15,20
285,253,Trump Wins,32,35,21
272,266,Trump Wins,6,10,13
276,262,Trump Wins,14,15,21
312,226,Trump Wins,86,90,9
291,247,Trump Wins,44,45,28
270,268,Trump Wins,2,5,27
316,222,Trump Wins,94,95,8
286,252,Trump Wins,34,35,22
270,268,Trump Wins,2,5,28
288,250,Trump Wins,38,40,17
272,266,Trump Wins,6,10,14
291,247,Trump Wins,44,45,29
292,246,Trump Wins,46,50,14
283,255,Trump Wins,28,30,13
278,260,Trump Wins,18,20,14
297,241,Trump Wins,56,60,14
281,257,Trump Wins,24,25,41
296,242,Trump Wins,54,55,21
293,245,Trump Wins,48,50,15
285,253,Trump Wins,32,35,23
295,243,Trump Wins,52,55,22
271,267,Trump Wins,4,5,29
275,263,Trump Wins,12,15,22
277,261,Trump Wins,16,20,15
276,262,Trump Wins,14,15,23
302,236,Trump Wins,66,70,13
293,245,Trump Wins,48,50,16
274,264,Trump Wins,10,15,24
297,241,Trump Wins,56,60,15
271,267,Trump Wins,4,5,30
285,253,Trump Wins,32,35,24
286,252,Trump Wins,34,35,25
333,205,Trump Wins,128,130,1
276,262,Trump Wins,14,15,25
274,264,Trump Wins,10,15,26
290,248,Trump Wins,42,45,30
299,239,Trump Wins,60,65,13
307,231,Trump Wins,76,80,7
280,258,Trump Wins,22,25,42
281,257,Trump Wins,24,25,43
281,257,Trump Wins,24,25,44
270,268,Trump Wins,2,5,31
312,226,Trump Wins,86,90,10
313,225,Trump Wins,88,90,11
308,230,Trump Wins,78,80,8
286,252,Trump Wins,34,35,26
272,266,Trump Wins,6,10,15
274,264,Trump Wins,10,15,27
280,258,Trump Wins,22,25,45
285,253,Trump Wins,32,35,27
319,219,Trump Wins,100,105,1
298,240,Trump Wins,58,60,16
271,267,Trump Wins,4,5,32
281,257,Trump Wins,24,25,46
310,228,Trump Wins,82,85,8
302,236,Trump Wins,66,70,14
287,251,Trump Wins,36,40,18
287,251,Trump Wins,36,40,19
272,266,Trump Wins,6,10,16
283,255,Trump Wins,28,30,14
314,224,Trump Wins,90,95,9
295,243,Trump Wins,52,55,23
281,257,Trump Wins,24,25,47
285,253,Trump Wins,32,35,28
306,232,Trump Wins,74,75,13
280,258,Trump Wins,22,25,48
278,260,Trump Wins,18,20,16
296,242,Trump Wins,54,55,24
293,245,Trump Wins,48,50,17
280,258,Trump Wins,22,25,49
295,243,Trump Wins,52,55,25
287,251,Trump Wins,36,40,20
292,246,Trump Wins,46,50,18
272,266,Trump Wins,6,10,17
312,226,Trump Wins,86,90,12
304,234,Trump Wins,70,75,14
287,251,Trump Wins,36,40,21
306,232,Trump Wins,74,75,15
272,266,Trump Wins,6,10,18
280,258,Trump Wins,22,25,50
270,268,Trump Wins,2,5,33
287,251,Trump Wins,36,40,22
297,241,Trump Wins,56,60,17
281,257,Trump Wins,24,25,51
285,253,Trump Wins,32,35,29
287,251,Trump Wins,36,40,23
309,229,Trump Wins,80,85,9
283,255,Trump Wins,28,30,15
282,256,Trump Wins,26,30,16
320,218,Trump Wins,102,105,2
280,258,Trump Wins,22,25,52
279,259,Trump Wins,20,25,53
293,245,Trump Wins,48,50,19
278,260,Trump Wins,18,20,17
275,263,Trump Wins,12,15,28
277,261,Trump Wins,16,20,18
293,245,Trump Wins,48,50,20
313,225,Trump Wins,88,90,13
280,258,Trump Wins,22,25,54
299,239,Trump Wins,60,65,14
273,265,Trump Wins,8,10,19
287,251,Trump Wins,36,40,24
291,247,Trump Wins,44,45,31
286,252,Trump Wins,34,35,30
315,223,Trump Wins,92,95,10
275,263,Trump Wins,12,15,29
271,267,Trump Wins,4,5,34
272,266,Trump Wins,6,10,20
281,257,Trump Wins,24,25,55
301,237,Trump Wins,64,65,15
278,260,Trump Wins,18,20,19
271,267,Trump Wins,4,5,35
275,263,Trump Wins,12,15,30
292,246,Trump Wins,46,50,21
275,263,Trump Wins,12,15,31
291,247,Trump Wins,44,45,32
289,249,Trump Wins,40,45,33
328,210,Trump Wins,118,120,5
311,227,Trump Wins,84,85,10
313,225,Trump Wins,88,90,14
285,253,Trump Wins,32,35,31
275,263,Trump Wins,12,15,32
275,263,Trump Wins,12,15,33
283,255,Trump Wins,28,30,17
286,252,Trump Wins,34,35,32
281,257,Trump Wins,24,25,56
283,255,Trump Wins,28,30,18
293,245,Trump Wins,48,50,22
281,257,Trump Wins,24,25,57
272,266,Trump Wins,6,10,21
272,266,Trump Wins,6,10,22
290,248,Trump Wins,42,45,34
290,248,Trump Wins,42,45,35
271,267,Trump Wins,4,5,36
279,259,Trump Wins,20,25,58
312,226,Trump Wins,86,90,15
301,237,Trump Wins,64,65,16
316,222,Trump Wins,94,95,11
280,258,Trump Wins,22,25,59
286,252,Trump Wins,34,35,33
286,252,Trump Wins,34,35,34
296,242,Trump Wins,54,55,26
274,264,Trump Wins,10,15,34
287,251,Trump Wins,36,40,25
276,262,Trump Wins,14,15,35
326,212,Trump Wins,114,115,4
270,268,Trump Wins,2,5,37
284,254,Trump Wins,30,35,35
281,257,Trump Wins,24,25,60
270,268,Trump Wins,2,5,38
278,260,Trump Wins,18,20,20
290,248,Trump Wins,42,45,36
287,251,Trump Wins,36,40,26
283,255,Trump Wins,28,30,19
271,267,Trump Wins,4,5,39
285,253,Trump Wins,32,35,36
298,240,Trump Wins,58,60,18
316,222,Trump Wins,94,95,12
282,256,Trump Wins,26,30,20
287,251,Trump Wins,36,40,27
277,261,Trump Wins,16,20,21
287,251,Trump Wins,36,40,28
306,232,Trump Wins,74,75,16
320,218,Trump Wins,102,105,3
277,261,Trump Wins,16,20,22
305,233,Trump Wins,72,75,17
314,224,Trump Wins,90,95,13
310,228,Trump Wins,82,85,11
293,245,Trump Wins,48,50,23
299,239,Trump Wins,60,65,17
312,226,Trump Wins,86,90,16
273,265,Trump Wins,8,10,23
287,251,Trump Wins,36,40,29
287,251,Trump Wins,36,40,30
292,246,Trump Wins,46,50,24
276,262,Trump Wins,14,15,36
312,226,Trump Wins,86,90,17
273,265,Trump Wins,8,10,24
280,258,Trump Wins,22,25,61
272,266,Trump Wins,6,10,25
273,265,Trump Wins,8,10,26
279,259,Trump Wins,20,25,62
298,240,Trump Wins,58,60,19
271,267,Trump Wins,4,5,40
272,266,Trump Wins,6,10,27
300,238,Trump Wins,62,65,18
281,257,Trump Wins,24,25,63
279,259,Trump Wins,20,25,64
294,244,Trump Wins,50,55,27
275,263,Trump Wins,12,15,37
275,263,Trump Wins,12,15,38
297,241,Trump Wins,56,60,20
297,241,Trump Wins,56,60,21
304,234,Trump Wins,70,75,18
297,241,Trump Wins,56,60,22
278,260,Trump Wins,18,20,23
280,258,Trump Wins,22,25,65
302,236,Trump Wins,66,70,15
293,245,Trump Wins,48,50,25
285,253,Trump Wins,32,35,37
287,251,Trump Wins,36,40,31
309,229,Trump Wins,80,85,12
322,216,Trump Wins,106,110,6
276,262,Trump Wins,14,15,39
285,253,Trump Wins,32,35,38
290,248,Trump Wins,42,45,37
322,216,Trump Wins,106,110,7
271,267,Trump Wins,4,5,41
281,257,Trump Wins,24,25,66
271,267,Trump Wins,4,5,42
277,261,Trump Wins,16,20,24
296,242,Trump Wins,54,55,28
268,270,Harris Wins,-2,-5,1
194,344,Harris Wins,-150,-150,1
245,293,Harris Wins,-48,-50,1
213,325,Harris Wins,-112,-115,1
259,279,Harris Wins,-20,-20,1
202,336,Harris Wins,-134,-135,1
263,275,Harris Wins,-12,-15,1
264,274,Harris Wins,-10,-10,1
266,272,Harris Wins,-6,-10,2
251,287,Harris Wins,-36,-40,1
252,286,Harris Wins,-34,-35,1
262,276,Harris Wins,-14,-15,2
178,360,Harris Wins,-182,-185,1
267,271,Harris Wins,-4,-5,2
262,276,Harris Wins,-14,-15,3
246,292,Harris Wins,-46,-50,2
252,286,Harris Wins,-34,-35,2
265,273,Harris Wins,-8,-10,3
254,284,Harris Wins,-30,-30,1
251,287,Harris Wins,-36,-40,2
265,273,Harris Wins,-8,-10,4
244,294,Harris Wins,-50,-50,3
241,297,Harris Wins,-56,-60,1
247,291,Harris Wins,-44,-45,1
255,283,Harris Wins,-28,-30,2
266,272,Harris Wins,-6,-10,5
262,276,Harris Wins,-14,-15,4
250,288,Harris Wins,-38,-40,3
255,283,Harris Wins,-28,-30,3
229,309,Harris Wins,-80,-80,1
245,293,Harris Wins,-48,-50,4
257,281,Harris Wins,-24,-25,1
211,327,Harris Wins,-116,-120,1
236,302,Harris Wins,-66,-70,1
262,276,Harris Wins,-14,-15,5
267,271,Harris Wins,-4,-5,3
252,286,Harris Wins,-34,-35,3
266,272,Harris Wins,-6,-10,6
238,300,Harris Wins,-62,-65,1
219,319,Harris Wins,-100,-100,1
264,274,Harris Wins,-10,-10,7
259,279,Harris Wins,-20,-20,2
260,278,Harris Wins,-18,-20,3
237,301,Harris Wins,-64,-65,2
260,278,Harris Wins,-18,-20,4
250,288,Harris Wins,-38,-40,4
267,271,Harris Wins,-4,-5,4
251,287,Harris Wins,-36,-40,5
266,272,Harris Wins,-6,-10,8
261,277,Harris Wins,-16,-20,5
265,273,Harris Wins,-8,-10,9
266,272,Harris Wins,-6,-10,10
251,287,Harris Wins,-36,-40,6
249,289,Harris Wins,-40,-40,7
249,289,Harris Wins,-40,-40,8
261,277,Harris Wins,-16,-20,6
261,277,Harris Wins,-16,-20,7
254,284,Harris Wins,-30,-30,4
252,286,Harris Wins,-34,-35,4
265,273,Harris Wins,-8,-10,11
240,298,Harris Wins,-58,-60,2
263,275,Harris Wins,-12,-15,6
265,273,Harris Wins,-8,-10,12
178,360,Harris Wins,-182,-185,2
268,270,Harris Wins,-2,-5,5
262,276,Harris Wins,-14,-15,7
261,277,Harris Wins,-16,-20,8
205,333,Harris Wins,-128,-130,1
248,290,Harris Wins,-42,-45,2
244,294,Harris Wins,-50,-50,5
251,287,Harris Wins,-36,-40,9
254,284,Harris Wins,-30,-30,5
235,303,Harris Wins,-68,-70,2
242,296,Harris Wins,-54,-55,1
254,284,Harris Wins,-30,-30,6
263,275,Harris Wins,-12,-15,8
246,292,Harris Wins,-46,-50,6
221,317,Harris Wins,-96,-100,2
261,277,Harris Wins,-16,-20,9
235,303,Harris Wins,-68,-70,3
265,273,Harris Wins,-8,-10,13
246,292,Harris Wins,-46,-50,7
256,282,Harris Wins,-26,-30,7
251,287,Harris Wins,-36,-40,10
234,304,Harris Wins,-70,-70,4
246,292,Harris Wins,-46,-50,8
199,339,Harris Wins,-140,-140,1
238,300,Harris Wins,-62,-65,3
246,292,Harris Wins,-46,-50,9
262,276,Harris Wins,-14,-15,9
234,304,Harris Wins,-70,-70,5
250,288,Harris Wins,-38,-40,11
250,288,Harris Wins,-38,-40,12
262,276,Harris Wins,-14,-15,10
264,274,Harris Wins,-10,-10,14
267,271,Harris Wins,-4,-5,6
254,284,Harris Wins,-30,-30,8
205,333,Harris Wins,-128,-130,2
241,297,Harris Wins,-56,-60,3
232,306,Harris Wins,-74,-75,1
265,273,Harris Wins,-8,-10,15
262,276,Harris Wins,-14,-15,11
246,292,Harris Wins,-46,-50,10
224,314,Harris Wins,-90,-90,1
246,292,Harris Wins,-46,-50,11
189,349,Harris Wins,-160,-160,1
246,292,Harris Wins,-46,-50,12
262,276,Harris Wins,-14,-15,12
241,297,Harris Wins,-56,-60,4
251,287,Harris Wins,-36,-40,13
260,278,Harris Wins,-18,-20,10
230,308,Harris Wins,-78,-80,2
254,284,Harris Wins,-30,-30,9
256,282,Harris Wins,-26,-30,10
244,294,Harris Wins,-50,-50,13
252,286,Harris Wins,-34,-35,5
267,271,Harris Wins,-4,-5,7
265,273,Harris Wins,-8,-10,16
253,285,Harris Wins,-32,-35,6
262,276,Harris Wins,-14,-15,13
251,287,Harris Wins,-36,-40,14
256,282,Harris Wins,-26,-30,11
222,316,Harris Wins,-94,-95,1
257,281,Harris Wins,-24,-25,2
235,303,Harris Wins,-68,-70,6
244,294,Harris Wins,-50,-50,14
251,287,Harris Wins,-36,-40,15
245,293,Harris Wins,-48,-50,15
219,319,Harris Wins,-100,-100,3
247,291,Harris Wins,-44,-45,3
254,284,Harris Wins,-30,-30,12
259,279,Harris Wins,-20,-20,11
251,287,Harris Wins,-36,-40,16
265,273,Harris Wins,-8,-10,17
251,287,Harris Wins,-36,-40,17
257,281,Harris Wins,-24,-25,3
235,303,Harris Wins,-68,-70,7
251,287,Harris Wins,-36,-40,18
249,289,Harris Wins,-40,-40,19
189,349,Harris Wins,-160,-160,2
262,276,Harris Wins,-14,-15,14
262,276,Harris Wins,-14,-15,15
263,275,Harris Wins,-12,-15,16
262,276,Harris Wins,-14,-15,17
254,284,Harris Wins,-30,-30,13
257,281,Harris Wins,-24,-25,4
209,329,Harris Wins,-120,-120,2
242,296,Harris Wins,-54,-55,2
260,278,Harris Wins,-18,-20,12
250,288,Harris Wins,-38,-40,20
252,286,Harris Wins,-34,-35,7
262,276,Harris Wins,-14,-15,18
267,271,Harris Wins,-4,-5,8
251,287,Harris Wins,-36,-40,21
231,307,Harris Wins,-76,-80,3
253,285,Harris Wins,-32,-35,8
262,276,Harris Wins,-14,-15,19
265,273,Harris Wins,-8,-10,18
256,282,Harris Wins,-26,-30,14
219,319,Harris Wins,-100,-100,4
240,298,Harris Wins,-58,-60,5
232,306,Harris Wins,-74,-75,2
267,271,Harris Wins,-4,-5,9
257,281,Harris Wins,-24,-25,5
230,308,Harris Wins,-78,-80,4
250,288,Harris Wins,-38,-40,22
235,303,Harris Wins,-68,-70,8
224,314,Harris Wins,-90,-90,2
238,300,Harris Wins,-62,-65,4
219,319,Harris Wins,-100,-100,5
265,273,Harris Wins,-8,-10,19
261,277,Harris Wins,-16,-20,13
234,304,Harris Wins,-70,-70,9
254,284,Harris Wins,-30,-30,15
228,310,Harris Wins,-82,-85,1
266,272,Harris Wins,-6,-10,20
251,287,Harris Wins,-36,-40,23
268,270,Harris Wins,-2,-5,10
245,293,Harris Wins,-48,-50,16
248,290,Harris Wins,-42,-45,4
262,276,Harris Wins,-14,-15,20
251,287,Harris Wins,-36,-40,24
262,276,Harris Wins,-14,-15,21
237,301,Harris Wins,-64,-65,5
255,283,Harris Wins,-28,-30,16
234,304,Harris Wins,-70,-70,10
246,292,Harris Wins,-46,-50,17
262,276,Harris Wins,-14,-15,22
252,286,Harris Wins,-34,-35,9
240,298,Harris Wins,-58,-60,6
266,272,Harris Wins,-6,-10,21
263,275,Harris Wins,-12,-15,23
266,272,Harris Wins,-6,-10,22
246,292,Harris Wins,-46,-50,18
251,287,Harris Wins,-36,-40,25
262,276,Harris Wins,-14,-15,24
252,286,Harris Wins,-34,-35,10
265,273,Harris Wins,-8,-10,23
264,274,Harris Wins,-10,-10,24
261,277,Harris Wins,-16,-20,14
261,277,Harris Wins,-16,-20,15
240,298,Harris Wins,-58,-60,7
237,301,Harris Wins,-64,-65,6
261,277,Harris Wins,-16,-20,16
250,288,Harris Wins,-38,-40,26
253,285,Harris Wins,-32,-35,11
235,303,Harris Wins,-68,-70,11
198,340,Harris Wins,-142,-145,1
245,293,Harris Wins,-48,-50,19
268,270,Harris Wins,-2,-5,11
251,287,Harris Wins,-36,-40,27
254,284,Harris Wins,-30,-30,17
249,289,Harris Wins,-40,-40,28
246,292,Harris Wins,-46,-50,20
263,275,Harris Wins,-12,-15,25
236,302,Harris Wins,-66,-70,12
258,280,Harris Wins,-22,-25,6
252,286,Harris Wins,-34,-35,12
235,303,Harris Wins,-68,-70,13
262,276,Harris Wins,-14,-15,26
265,273,Harris Wins,-8,-10,25
249,289,Harris Wins,-40,-40,29
242,296,Harris Wins,-54,-55,3
256,282,Harris Wins,-26,-30,18
262,276,Harris Wins,-14,-15,27
264,274,Harris Wins,-10,-10,26
266,272,Harris Wins,-6,-10,27
251,287,Harris Wins,-36,-40,30
254,284,Harris Wins,-30,-30,19
252,286,Harris Wins,-34,-35,13
257,281,Harris Wins,-24,-25,7
258,280,Harris Wins,-22,-25,8
261,277,Harris Wins,-16,-20,17
261,277,Harris Wins,-16,-20,18
266,272,Harris Wins,-6,-10,28
251,287,Harris Wins,-36,-40,31
219,319,Harris Wins,-100,-100,6
230,308,Harris Wins,-78,-80,5
241,297,Harris Wins,-56,-60,8
259,279,Harris Wins,-20,-20,19
268,270,Harris Wins,-2,-5,12
222,316,Harris Wins,-94,-95,2
195,343,Harris Wins,-148,-150,2
265,273,Harris Wins,-8,-10,29
263,275,Harris Wins,-12,-15,28
251,287,Harris Wins,-36,-40,32
244,294,Harris Wins,-50,-50,21
256,282,Harris Wins,-26,-30,20
226,312,Harris Wins,-86,-90,3
265,273,Harris Wins,-8,-10,30
251,287,Harris Wins,-36,-40,33
261,277,Harris Wins,-16,-20,20
262,276,Harris Wins,-14,-15,29
265,273,Harris Wins,-8,-10,31
235,303,Harris Wins,-68,-70,14
260,278,Harris Wins,-18,-20,21
266,272,Harris Wins,-6,-10,32
247,291,Harris Wins,-44,-45,5
245,293,Harris Wins,-48,-50,22
257,281,Harris Wins,-24,-25,9
245,293,Harris Wins,-48,-50,23
265,273,Harris Wins,-8,-10,33
268,270,Harris Wins,-2,-5,13
264,274,Harris Wins,-10,-10,34
249,289,Harris Wins,-40,-40,34
235,303,Harris Wins,-68,-70,15
252,286,Harris Wins,-34,-35,14
249,289,Harris Wins,-40,-40,35
230,308,Harris Wins,-78,-80,6
189,349,Harris Wins,-160,-160,3
205,333,Harris Wins,-128,-130,3
256,282,Harris Wins,-26,-30,21
230,308,Harris Wins,-78,-80,7
262,276,Harris Wins,-14,-15,30
244,294,Harris Wins,-50,-50,24
267,271,Harris Wins,-4,-5,14
230,308,Harris Wins,-78,-80,8
246,292,Harris Wins,-46,-50,25
245,293,Harris Wins,-48,-50,26
251,287,Harris Wins,-36,-40,36
246,292,Harris Wins,-46,-50,27
235,303,Harris Wins,-68,-70,16
252,286,Harris Wins,-34,-35,15
256,282,Harris Wins,-26,-30,22
221,317,Harris Wins,-96,-100,7
240,298,Harris Wins,-58,-60,9
254,284,Harris Wins,-30,-30,23
216,322,Harris Wins,-106,-110,1
262,276,Harris Wins,-14,-15,31
265,273,Harris Wins,-8,-10,35
244,294,Harris Wins,-50,-50,28
221,317,Harris Wins,-96,-100,8
242,296,Harris Wins,-54,-55,4
247,291,Harris Wins,-44,-45,6
245,293,Harris Wins,-48,-50,29
259,279,Harris Wins,-20,-20,22
225,313,Harris Wins,-88,-90,4
249,289,Harris Wins,-40,-40,37
227,311,Harris Wins,-84,-85,2
265,273,Harris Wins,-8,-10,36
246,292,Harris Wins,-46,-50,30
264,274,Harris Wins,-10,-10,37
267,271,Harris Wins,-4,-5,15
252,286,Harris Wins,-34,-35,16
229,309,Harris Wins,-80,-80,9
259,279,Harris Wins,-20,-20,23
251,287,Harris Wins,-36,-40,38
192,346,Harris Wins,-154,-155,1
268,270,Harris Wins,-2,-5,16
252,286,Harris Wins,-34,-35,17
256,282,Harris Wins,-26,-30,24
235,303,Harris Wins,-68,-70,17
230,308,Harris Wins,-78,-80,10
235,303,Harris Wins,-68,-70,18
246,292,Harris Wins,-46,-50,31
262,276,Harris Wins,-14,-15,32
268,270,Harris Wins,-2,-5,17
265,273,Harris Wins,-8,-10,38
205,333,Harris Wins,-128,-130,4
240,298,Harris Wins,-58,-60,10
261,277,Harris Wins,-16,-20,24
253,285,Harris Wins,-32,-35,18
237,301,Harris Wins,-64,-65,7
256,282,Harris Wins,-26,-30,25
259,279,Harris Wins,-20,-20,25
240,298,Harris Wins,-58,-60,11
252,286,Harris Wins,-34,-35,19
263,275,Harris Wins,-12,-15,33
267,271,Harris Wins,-4,-5,18
267,271,Harris Wins,-4,-5,19
264,274,Harris Wins,-10,-10,39
268,270,Harris Wins,-2,-5,20
195,343,Harris Wins,-148,-150,3
219,319,Harris Wins,-100,-100,9
238,300,Harris Wins,-62,-65,8
237,301,Harris Wins,-64,-65,9
253,285,Harris Wins,-32,-35,20
252,286,Harris Wins,-34,-35,21
268,270,Harris Wins,-2,-5,21
256,282,Harris Wins,-26,-30,26
262,276,Harris Wins,-14,-15,34
262,276,Harris Wins,-14,-15,35
241,297,Harris Wins,-56,-60,12
262,276,Harris Wins,-14,-15,36
259,279,Harris Wins,-20,-20,26
250,288,Harris Wins,-38,-40,39
235,303,Harris Wins,-68,-70,19
254,284,Harris Wins,-30,-30,27
268,270,Harris Wins,-2,-5,22
265,273,Harris Wins,-8,-10,40
257,281,Harris Wins,-24,-25,10
265,273,Harris Wins,-8,-10,41
224,314,Harris Wins,-90,-90,5
231,307,Harris Wins,-76,-80,11
234,304,Harris Wins,-70,-70,20
256,282,Harris Wins,-26,-30,28
240,298,Harris Wins,-58,-60,13
256,282,Harris Wins,-26,-30,29
267,271,Harris Wins,-4,-5,23
267,271,Harris Wins,-4,-5,24
264,274,Harris Wins,-10,-10,42
229,309,Harris Wins,-80,-80,12
265,273,Harris Wins,-8,-10,43
267,271,Harris Wins,-4,-5,25
248,290,Harris Wins,-42,-45,7
223,315,Harris Wins,-92,-95,3
267,271,Harris Wins,-4,-5,26
253,285,Harris Wins,-32,-35,22
252,286,Harris Wins,-34,-35,23
245,293,Harris Wins,-48,-50,32
256,282,Harris Wins,-26,-30,30
264,274,Harris Wins,-10,-10,44
231,307,Harris Wins,-76,-80,13
246,292,Harris Wins,-46,-50,33
255,283,Harris Wins,-28,-30,31
262,276,Harris Wins,-14,-15,37
251,287,Harris Wins,-36,-40,40
212,326,Harris Wins,-114,-115,2
262,276,Harris Wins,-14,-15,38
236,302,Harris Wins,-66,-70,21
255,283,Harris Wins,-28,-30,32
268,270,Harris Wins,-2,-5,27
221,317,Harris Wins,-96,-100,10
261,277,Harris Wins,-16,-20,27
222,316,Harris Wins,-94,-95,4
266,272,Harris Wins,-6,-10,45
230,308,Harris Wins,-78,-80,14
219,319,Harris Wins,-100,-100,11
257,281,Harris Wins,-24,-25,11
257,281,Harris Wins,-24,-25,12
246,292,Harris Wins,-46,-50,34
267,271,Harris Wins,-4,-5,28
263,275,Harris Wins,-12,-15,39
257,281,Harris Wins,-24,-25,13
256,282,Harris Wins,-26,-30,33
255,283,Harris Wins,-28,-30,34
206,332,Harris Wins,-126,-130,5
240,298,Harris Wins,-58,-60,14
261,277,Harris Wins,-16,-20,28
250,288,Harris Wins,-38,-40,41
234,304,Harris Wins,-70,-70,22
235,303,Harris Wins,-68,-70,23
234,304,Harris Wins,-70,-70,24
251,287,Harris Wins,-36,-40,42
265,273,Harris Wins,-8,-10,46
236,302,Harris Wins,-66,-70,25
247,291,Harris Wins,-44,-45,8
249,289,Harris Wins,-40,-40,43
262,276,Harris Wins,-14,-15,40
266,272,Harris Wins,-6,-10,47
216,322,Harris Wins,-106,-110,2
251,287,Harris Wins,-36,-40,44
236,302,Harris Wins,-66,-70,26
262,276,Harris Wins,-14,-15,41
266,272,Harris Wins,-6,-10,48
261,277,Harris Wins,-16,-20,29
250,288,Harris Wins,-38,-40,45
258,280,Harris Wins,-22,-25,14
254,284,Harris Wins,-30,-30,35
249,289,Harris Wins,-40,-40,46
190,348,Harris Wins,-158,-160,4
256,282,Harris Wins,-26,-30,36
266,272,Harris Wins,-6,-10,49
246,292,Harris Wins,-46,-50,35
264,274,Harris Wins,-10,-10,50
248,290,Harris Wins,-42,-45,9
257,281,Harris Wins,-24,-25,15
252,286,Harris Wins,-34,-35,24
252,286,Harris Wins,-34,-35,25
245,293,Harris Wins,-48,-50,36
266,272,Harris Wins,-6,-10,51
246,292,Harris Wins,-46,-50,37
227,311,Harris Wins,-84,-85,3
217,321,Harris Wins,-104,-105,1
224,314,Harris Wins,-90,-90,6
241,297,Harris Wins,-56,-60,15
224,314,Harris Wins,-90,-90,7
256,282,Harris Wins,-26,-30,37
251,287,Harris Wins,-36,-40,47
258,280,Harris Wins,-22,-25,16
223,315,Harris Wins,-92,-95,5
256,282,Harris Wins,-26,-30,38
230,308,Harris Wins,-78,-80,15
252,286,Harris Wins,-34,-35,26
264,274,Harris Wins,-10,-10,52
252,286,Harris Wins,-34,-35,27
259,279,Harris Wins,-20,-20,30
252,286,Harris Wins,-34,-35,28
237,301,Harris Wins,-64,-65,10
262,276,Harris Wins,-14,-15,42
241,297,Harris Wins,-56,-60,16
241,297,Harris Wins,-56,-60,17
219,319,Harris Wins,-100,-100,12
266,272,Harris Wins,-6,-10,53
220,318,Harris Wins,-98,-100,13
254,284,Harris Wins,-30,-30,39
214,324,Harris Wins,-110,-110,3
268,270,Harris Wins,-2,-5,29
255,283,Harris Wins,-28,-30,40
200,338,Harris Wins,-138,-140,2
231,307,Harris Wins,-76,-80,16
256,282,Harris Wins,-26,-30,41
233,305,Harris Wins,-72,-75,3
231,307,Harris Wins,-76,-80,17
245,293,Harris Wins,-48,-50,38
251,287,Harris Wins,-36,-40,48
256,282,Harris Wins,-26,-30,42
269,269,No Winner,0,0,1
269,269,No Winner,0,0,2
269,269,No Winner,0,0,3
269,269,No Winner,0,0,4
269,269,No Winner,0,0,5
269,269,No Winner,0,0,6
269,269,No Winner,0,0,7
269,269,No Winner,0,0,8
269,269,No Winner,0,0,9
269,269,No Winner,0,0,10
